################################################################################
#                   #                         #                                #
#   7           7   #                         #                                #
#     @             #                         #                                #
#            *      #                         #                                #
##########|##########            #            #                      x         #
#                   #            #            #                                #
#                   #            #            #                                #
#                   #            #            #                                #
#                   ##############            #     x                          #
#                                             #                                #
#                                             #                                #
#                                             #                                #
#                                             #                                #
#                                             #                                #
#                                    x        #                                #
#                                             #                                #
#                                             #              x                 #
#                                                                              #
#     x                                                                        #
#                                       x                                      #
#                                                                              #
###################################                                            #
#                                                                              #
#                                                                              #
#                                                                              #
#                                                                              #
#                                                                              #
#                                             x                                #
#                                                                              #
#                                                                              #
#                                                                              #
#                             #                                                #
#                             #                                                #
#                             #                                                #
#                             #                                                #
#         x                   #        ###############################   x     #
#                             #        #                             #         #
#                             #        #                             #         #
#                             #        #       ############          #         #
#                             #        #       #          #          #         #
#                             ##########       #   x      #          #         #
#                                              #          #          #         #
#                                              # ##########          ###########
#           x                                  # #                             #
#################                              # #                             #
#               #             ################## #             #############|###
#               #             #                  #             #   G           #
#               #             #                  #             #               #
################################################################################